 #####
 #   ##
## * .##
# $$*  #
#  * . #
## @ ###
 #####